sf=select * from
scf=select count(*) from
sdf=select distinct * from
scdf=select count(distinct *) from
ct=count(*)
df=delete  from
instto=insert into
instiv=insert into t1 values()
upst=update t1 set t1.
fup=for update ;
wh=where
odb=order by
gpb=group by
hv=having
ljo=letf join  on
rjo=right join  on
fjo=full join  on
ijo=inner join  on
lj=left join
rj=right join
ij=inner join
fj=full join
rn=rownum
dpt=drop table
crt=create table
trt=truncate table
dc=declare
prd=procedure
crp=create procedure  as
cropoc=create or replace procedure as
coc=comment on column t1.cl1 is 'str';
cot=comment on table t1 is 'str';
ssfd=select sysdate from dual
sysut=user_tables
sysutdesc=user_tab_comments
sysuc= user_tab_columns
sysucdesc=user_col_comments
crv=create view  as
rn10=rownum <= 10
rn100=rownum <= 100
